Spells

1st Circle
BET IN SANCT	Resist Blows
IN LOR		Light
IN MANI YLEM	Create Food
ORT JUX		Magic Arrow 
SANCT HUR		Stealth
UUS POR		Leap


2nd Circle
AN SANCT		Curse
IN BET MANI		Lesser Heal
IN JUX		Rune of Warding
QUAS CORP		Cause Fear
REL DES POR		Slow Fall
WIS MANI		Detect Monster


3rd Circle
BET SANCT LOR	Conceal
IN SANCT		Thick Skin
ORT GRAV		Lightning
QUAS LOR		Night Vision
REL TYM POR	Speed
SANCT JUX		Strengthen Door


4th Circle
AN JUX		Remove Trap
HUR POR		Levitate
IN MANI		Heal
NOX MANI		Poison
SANCT FLAM	Flameproof
YLEM POR		Water Walk


5th Circle
AN CORP MANI	Smite Undead
AN NOX		Cure Poison
EX YLEM		Open
GRAV SANCT POR	Missile Protection
ORT WIS YLEM	Name Enchantment
POR FLAM		Fireball


6th Circle
AN EX POR		Paralyze
ORT POR YLEM	Telekinesis
VAS IN LOR		Daylight
VAS IN MANI	Greater Heal
VAS ORT GRAV	Sheet Lightning
VAS REL POR		Gate Travel


7th Circle
IN MANI REL		Ally 
KAL MANI		Summon Monster
ORT AN QUAS	Reveal
VAS AN WIS		Confusion
VAS HUR POR	Fly 
VAS SANCT LOR	Invisibility


8th Circle
AN TYM		Freeze Time
FLAM HUR		Flame Wind
IN VAS SANCT	Iron Flesh
ORT POR WIS	Roaming Sight
VAS KAL CORP	Armageddon
VAS POR YLEM	Tremor

